111111111111111111111111111111111111111
1P0C00000000000C00000000000C00000000001
100E00000000000C00000000000C00000000001
100000000000000000000C00000000000C00001
100000000000000000000C00000000000C00001
100000000000000000000C00000000000C00001
100000000000000000000C00000000000C00001
100000000000000000000C00000000000C00001
100000000000000000000C00000000000C00001
100000000000000000000C00000000000C00001
100000000000000000000C00000000000C00001
100000000000000000000C00000000000C00001
100000000000000000000C00000000000C00001
100000000000000000000C00000000000C00001
100000000000000000000C00000000000C00001
111111111111111111111111111111111111111