111111
1P0C11
101111
101E11
111111