11111111111
10P00000001
100000E00X1
1CCCCCCCCC1
11111111111