11111111111111111
1110C000C000C0111
11000000000000011
11001100C00110011
110C110000011C011
1100C000P000C0011
1100000CEC0000011
1110C0000000C0111
11110011111001111
11110010101111111
11111C0C0C1C11111
11111111111111111